WWWWWWWWEW
WEWEWEWEEW
WEEEWEEEWW
WEEWWEWWWW
WEEWDEWEWW
WEEEEEEEEW
WEEWEEEWEW
WEWWEWEWEW
WPEEEWEEEW
WWWWWWWWWW