WWWWWWWWEW
WEWEEEWEEW
WEEEWWEEWW
WEEWEEWDEW
WEEWEEWEEW
WEEEEEEEEW
WEEWWWEWEW
WWWEEEEWEW
WPEEWWEEEW
WWWWWWWWWW