WWWWWWWWEW
WEWEEEEEEW
WEEEWWEWWW
WEEWEEWEEW
WWEWEEWEWW
WEEEEEDEEW
WWEWWWEWEW
WWWEEEWWEW
WPEEWEEEEW
WWWWWWWWWW