WWWWWWWWEW
WEWEEEWEEW
WEEEWEEEWW
WEEWWEWWWW
WWEWEEWEWW
WEEEEEEEEW
WWEWEEEWDW
WEWWEWEWEW
WPEEEWEEEW
WWWWWWWWWW