WWWWWWWWEW
WEWWEWEEEW
WEEEEEEWWW
WEEWWWWEWW
WWEWEEWEWW
WEEEEEEEEW
WWEWWEEWDW
WEWWEWWWEW
WPEEEEEEEW
WWWWWWWWWW