WWWWWWWWEW
WEWEWWEWEW
WEEWEEEEEW
WEWWWWWEWW
WEEEWEWEWW
WWEWEEWEWW
WEEEEEEEEW
WEEWWEEWDW
WPWWEWWWEW
WWWWWWWWWW
