WWWWWWWWEW
WEWEWWEEEW
WEEWEEEWEW
WEWWWWEEWW
WEEEWEWEWW
WWEWEEWEWW
WEEEEEEEEW
WEEWWEEWDW
WPEWWEWWEW
WWWWWWWWWW