WWWWWWWWEW
WDWEWWEEEW
WEEWEEEWEW
WEWWEWEEWW
WEEEEEWEWW
WWEWEEWEWW
WEEEEEWEEW
WEEWWEEWEW
WPEWWEWWEW
WWWWWWWWWW