WWWWWWWWEW
WEWEWEWEEW
WEEEWEEEWW
WEEWWEWEWW
WWEWEEWEWW
WEDEEEEEEW
WWEWEEEWEW
WEWWEWEWEW
WPEEEWEEEW
WWWWWWWWWW