WWWWWWWWEW
WEWEEEWEEW
WEWEWEEEWW
WEEWWEWWWW
WWEWEEWEWW
WEEEWEEEEW
WWEWEEEWDW
WEWWEWEWEW
WPEEEWEEEW
WWWWWWWWWW